####....##..####..##.#.#.##..##...##.####....####.##..#.######.#####..##.#..#..#..###.#..###........#...########...#.#........#...####...#...##...####..###..#..#..##..#####...##.######...###.##.##..#...##....#.#...#.######.##.##.#..#.#..#..####.#####....#.##.####..#.##..#...##.#.#####.#..##......###.#..###.##.#.#..##...###..#..#..#.###...##.#....#.....##...##..#.##.#.#.....###..#.#...####..#..##.####...###...##...###..#....####..####..#.###.###.##.#.#.#.###.##.#.#.#..#.#...##...#.#.##..#..###.##..##.###.##.

#.#....#...#..#.....###.....#...##.#####.#.#.##.#.###.###.##.##.........########......##...#....##..
..#.#..#...#.###...#..#..#.....###.#.#.##.#.##.#..###.###.#..#.##.#.##.#.#.#...####.#.......#..##...
##..##...#.#########.###..#####..###.###.####....###.#.#.###.#.#..#..#.#...####..###.#.##.#####.##..
.#.##....##..#.###..#....#.#..##..####.#..#.#####.#.#...#.....#.##.#.#.#...#..#......#.#.#.##..#.#.#
##..#.##.#.#.#.##....####.#.#.....#.....#....#....#...###..###..######.#...#.#.....#.#.##...##..##..
###..#......##.....#..##.#.#...#...#.##..##..###.####...###.#...##.#.#.#.##.#....###...######...#.##
...##.#..#.#.#.####.####..#.#.#.##.#...#.....#.#..#.#####..###.#...#..#...####...#....##..##..#....#
.#.#.....##...#.##..#.##..##.#######.##..#...#..#.######.#.##..#..#......###.#..##.#.#...###.##..#..
.##.#######.##..#...#..###.###...##.##..#.#...#..#.#..###.##.#..#.##.#.#.##.####..#..###.###.##.#.#.
#..###...#.####.#...##.###...##..#.######..#.#........##.#...#..#.##.#....#####...#..#.#.##.#....###
#..####.#.#.##..#.#.##...#...###....#...#.....###..##...##.#.##.#....##..##.##.#####.#.#.##.###..##.
####.####..#.#..###.#..#####......#...####.##.#..##.##..#...#..#.#####...#...#...###.##.##........##
#.....###..#.###.#...##.#####...###...###.#.##.###.###.##.####..#..#.....#...##.#.....#.##..#..#....
.##..#.######..#.#.#.....#.#..###.#.####.##.#...##..#..#.#.##..#.....#.####.#.#.#...##.##..#......##
#.##...###.##.##.#...####.#..#...#.#..#.###.#.#.##.##..###.##.##.#..##..#.#.#.#..#.###.#...###..#.##
###...#.#.##.#.#.#.##.#.###.##..#.#.##..#.##..####.##..#...##.#.###....###..###..###.#..#.##..#.#.##
.......###...#####.#####.#.####..#....##.##.###.#.#.#.#.#...#.#.###.####.#..###.####.#.#..#..#######
#.#........###..###..#...####..##.#..####....#.#...##.#....#..###..##......#..###....###.#.###...#.#
...#.#....#...##..###.##.####.....####.........#..#..#.#.#.###.#..##.####........###.###.#..#.#...#.
##.######...###.....#.##..#..##..#.#.#..#...#.#...##.#.##...######.#.#...###..#.########.#.##.###...
##..#..#..#.##...#.##.........##..#####.#.##.#.####...#.#.#...#...##.####..#...######..#.....##..#..
...#..#.###..#.##.###...#....#..#...#.###..####.#..######.##..#....##...####...##..#.#.#.###.###....
.##.###..####.##....#....######...#..####.##...###.##.#.#.##..##.....####.#..#.###.##...#....####.##
####.######.#..#...###.#.#.#.....####....#.#..#....##...##.#######.#..#..#.######.##......#...##...#
.#####..#..##...###.###.#.#....###.###.##...#.#...#..#..#..#.........#.##..#.....#....####..####.###
#..##.#.###.#......##...#.###..##.##.#.#..#.#.##..###.#..........#..#...#.###.###..###.#.#..#..#....
......#.####..#.####..#....##..####.##..#....##.#.#........#.#####..###....###..###.#..#.#.#.#.##.##
#..#.....####.#.##.#..#..#...#.#..##..##.#.#.####..#...#..#.#.#.#....#.###.###..##.#.#...###.###.#..
.##..#..####.##.#...####...#.#.#.#.#.#..#.#...##..#....#.#..#..#.#.##..#.#..##..#.#.#...##..###.##..
..#.#..#.....##.###.##.#####.......###..##.##..#..###..##..#.....##.#.#.....##.#########.####.#.####
##....####..#....#.########...##.###....#......#..###..###.#.####.##.#######.#############...#.##.#.
##..##....#..#..#...#.#.#.##..##..#.###....##..#..##.#.#...#.....#....#..#....#.###.#...#...#.##..##
##.#..##..#..###.##.....#..#.##...##....#.#..##.#.....#.#...##......##########.....#....#.####......
.###.#....##..#..##..#####.###.#.##.#.####..###.#.###..#.##....####..#.#...#.#.#..#####...####.##..#
....#..####..#.......#.#.......##...##.#.###..##.........##..##...##.#..###..#.#....#.####.#...#.###
#.#.#.####.#.#.#.#....##.#...#..##.#.##..##.#.##..#.#..#.#.#..#####..###.#..#..#.#..##.#...#..#..#.#
.#..##....##.#...#.......###.#####.#........#.###.###.###..##.###...#.#....#...####.###.##..###.##..
.#.##.##.#.#..####.#..##.###..##..##.##.#.#####..#..#.#..#.##.#.####.#.##.#...##....#.....#.####.##.
##.##.#.#########.#....##.##.#####....#..#..###.#..##.#..##.#.#.#######.##.#......##.##..#.####...#.
#.....#.##...##...##.#.#...###.#####.#.##.####.##.#..#..##.#####.##..###.......#.#...##...#..###.#.#
.#.#####.##.##.#.#..##...#..#.#####...#.##.####.##.#.#.##.#.##.#..#....#.....###..##.##.##.#.#.#.###
##.##.#.#.#..#..#..##.#####.#...##.#...##..#.#..#..#.#...#.###..###.#...#..##...###.......#...#.#.#.
.#.....#..##......#.#..###.#..#.##..##.#.....##.##...#....#.##.#......#.#..#..###..#.#..####.##..###
...###.....#.##..####.##.#.#...#.......##..###.###..##.#.#....#...#.#..#.###.####..###...#....#...#.
..#.....#...###.##.##.#....#.##..#.#####..###.####.##..#.##.##.##..#.#.###.#.#.#...##....###.#.##...
.#########...#...##..###.#.###.#...#...#.###.###..###....###..#.##...##.#.#...#.#.####..#..#...#####
##..##..#..#....#....#####....###...#.##.###.#.#.#.....#..##..###.#.#..##.#.#..##....#.###.##..#..##
.....#.##...##......#..#.####....#.##.#####...#..#..#.###..####..#.####.##..#.####.#.#.....###..#..#
###....##.#..##....#####..#.#####.####....#....##.......#####.#...#.....#..#.###...##.#..#.###..#.##
#.##..#...##...##.#.###.###.#.#...#...#..#####.#..#.###.#.##.###.####...#.#.##..##.#.######.###..#..
.#.####...##.###.#.....#.##########.###.#####...###.#...###.#....#..##..##....##.##....#.##...#.##.#
###..#.#######.##.#####..######......#.#..#.#..#....######.##.###.###.#.##.#.##..#..##..###..##..###
....###.######.###.....##...#..#...##..###..########.#.##...####....##.###.#.##..##.#.....##.#.###..
#...#....#..##.#.#.#..#..#.#...#.#..#.###.######.##.####....#.##....##.###.##.##.......#.##..#.##...
###.#.#.#...#.#.#.#.#..#.####..##..##.##..##.#.##..##.###.####.#####..#.####...##.....#.#.##...#.##.
###.....#####.#...#.#....##...#..####...##.##.#..#.....#.##.#....######.##.##..#.#..#####.#...##...#
.#..##.###.###..#######.#.#.###...##.###.#.#.###.#.#####.##......#.##.....#..####.#.##.##.....#..###
##....##.#.##.#..#.##.###.##.####..#.##...#.#.##..##.#.#...##.#.#.##....#.#.#.....##....######.#.#.#
...#.##.#.#.#....#.###.#.###...##....#..#..##...#.##.#.....##.#.###...###...#.#...###.#.##.##..##.##
.#.#..#..#....##....#######..#...##.##.....#..###.##.#..#....#..##.##.#...#####.#....##....######.##
#.#.##..##..###.....#.##.##.###...###.##.#.#...#....####.......#....#..##.##...##....#...#.####..###
.#.##..#.....######.##..##.###....#####..#...#.####..##..#.#.###...####....#.##....###.##..######...
..###.######..###.....#...#.#..##....##..#...######.#.#.#...###.##....#.#..####.#######..##.....#..#
#...#.#####...#.###..#....#.#....#..#...##.#...#.#..#.##..##..#..##..#.#.###.#.#.##.#.##.......#####
###..#.##.#.#.#.....##.##.###..####....##..#..#..#.###..##.....#.....######.....#.###.#####.##.#####
.##..#.#.###.##.#.#.#..#......##...#..##.###..#.###.#.#.#...##.###...#.....#.##.#.#..##.##.#....##..
##.#..#.#####.##..#.#.##.###....###.......###......#..#...###.##.#.##########.##.##.##.###.#.##.....
.###.#..#####..##..#.####..#.#..######....####.###..#.##.####..#..#...##.#.#.####.####.#.##..####...
###.###.#.#.#..##..###..#....##.#..##.###.##.#.#......###....####.#......#.#.#...#.....##......####.
###.#.####.######..###..##.#.#....#####.#..#....#.##.##..#####.#......#...##....#..#.#.##..####.####
#..#...####..####.####.#..#.##..#.#.#.####..#.####...##....#..####.#.#........#.##......#.....##.#.#
..#..#.#####.#...#.###..##.#..#..#..#...#...#...###.#####.#.##..#.######...##.###....#######....#.##
.#.#........#.##.#.######.###.######..#..##.##.#...#.###.#..####.#.##.######.###..###..........#..##
..###.#.#..#.####...#.##...#....##############.#.#..####.###.#..##...#####.#.##.#..#####.#..#...###.
.#####.######.##...#.#.#..###.##..###.#.##.##....####..#.###...#.#.#...#..#..#.#..##......#..##.#...
.#.#..####.#.###.##..#.#.#.##..##.#..#.########..#..###...##....###.##.#...#.#.#.##.#..#.#..#..#..#.
.##...#.#.#####......##.####.####...#.#######..#..#...#..#####.#.........#####..#.###.#.#.##...##..#
#..#.#..#.#..##.#.##.###.#..##.#..#..####.###.##.########.#.##..#.....#..#....#.##..#..######..#####
.#.#...####..##..####....#.#.###.#.#...##.#.#..####.######..#.#.#.#...#..##...#....#####....####.##.
###...#.#..##..#.#..###.###...##.#..#.###..#.###..#.#...#.#..#.#..##...##..###.#.#....####..#....#.#
##....#.###.####..#.###.#..#######.###.....###...#.##....######.#.##..#####...###..#....##...#..###.
###....####......####.##.#..#...###.##..#...##..#.##..####..###.###..#..#..###..#.###...#.####..#..#
#...#...##..#...###...#..#####...#####.##...#..#.#####.....#####.......##..####....##.....##..#..##.
####..####.##..#.#..#####...#.#..##.#..##.###..#..###..#.....##.##..#..#.####.#..#..###.##..##..##..
####..#......##.#.#.#....#..###..####.##..##.###.##.....#......#.###...#...###.#..#..#.###.##.###...
..##.####..#..........###.#..##.####..#..##.##..##.####.#.##.####.....#.#.#..####.#####.##...#..####
..#....#..#.....#.##.#####.####...##.#.#.##..###..#.######.#.....##.######..#..#.##.##.#...#####.###
........#.#.....#.#.###...#######.#........#.#####.#.####...##.#.##..###...#......#.##.#.#.#..###.##
....#..##.#..#.###.....#...#..###.####.###.##..##...#.#..#....#.#.###.##.#..#...##.##..##..####..#.#
.#.#.##...#...#...#.#.#.####.####.#...#.#....#....##..#......#.#####.#.##.##.##.###...#.#####...#..#
###..##....#......########.##.##.##.##.#....####.###..#..##.##...#..##.#...##..##.####.####.##.#..##
#......###.###.##.....#.........#....###.#...##.###......##.#.....##..###.....##.##.###....##.#.#..#
.##.#.#.##.....#..#.#....#####.#.#...#.##..###.#####.###..###.##.....#.#...#..###..##..#...#.#..##..
########.#.#.##.#.##..#..#.#.#..#.###.#.##.######..#.####...##.##....###..#....#...#..#.#...##...#..
#....#.#####.#....######...##.#.###.#..####.##.###.###...####..#.#.##...#...##...##....####.#.......
..###..#..####.##.#.#####...###.#...###...#.#..##..##...##.##.#.##.#.#...##.....#..#.#.######.####.#
#..###.#..#.#..#.#.....##.#.#.#.#....#.#..#..#.###.#.##...#...##..###.#...#...#######..####..#.....#
#..####.#####....####.#.#.#.#.##.#.#...#####...##.###..###.#.#............###.####..##..##.###..###.
...#..#..#...#.#######.#.##..##..#..#.#..###.###..#.#####....#..#...####.#..##..###.##..######.##.##
##.#..#....#.#..###...#.#########.#####..#...#.####..#.#..#######.#....#.#.#.#..###.#.#..#...#.####.
